##########################################
#...................##...................#
#.########.########.##.########.########.#
#.########.########.##.########.########.#
#.########......................########.#
#..........#########.##########..........#
##.#######.##...1.......2...###.###.######
#..#######.##.##....x....##.###.###....###
##.#######....##4.......3##.....###.######
#..........##.#############.###.........##
#.######.####...................#######.##
#..#####.####.#############.###.#######.##
##.#####.####......###......###..........#
#........#########.###.#################.#
#.################.###.#################.#
#...................p....................#
##########################################
