[-   ][-   ][-   ][-   ][-   ][-   ][-   ][-   ][-   ][-   ][-   ][-   ][-   ][-   ][-   ]
[-   ][-   ][-   ][-   ][-   ][-   ][-   ][-   ][-   ][-   ][-   ][-   ][-   ][-   ][-   ]
[-   ][-   ][-   ][-   ][-   ][-   ][-   ][-   ][-   ][-   ][-   ][-   ][-   ][-   ][-   ]
[#=- ][#=- ][#=- ][#=- ][#=- ][#=- ][#=- ][#=- ][#=- ][#=- ][#=- ][#=- ][#=- ][#=- ][#=- ]
[#=- ][-   ][-   ][#=- ][-   ][-   ][-   ][-   ][-   ][-   ][-   ][#=- ][-   ][-   ][#=- ]
[#=- ][-   ][-   ][#=- ][-   ][-   ][-   ][-   ][-   ][-   ][-   ][#=- ][-   ][-   ][#=- ]
[#=- ][<4o ][-   ][#=- ][-   ][-   ][-   ][-   ][-   ][-   ][-   ][#=- ][-   ][<4o ][#=- ]
[#=- ][    ][    ][    ][    ][    ][    ][    ][    ][    ][    ][    ][    ][    ][#=- ]
[#=- ][    ][    ][    ][    ][    ][    ][    ][    ][    ][    ][    ][    ][    ][#=- ]
[#=- ][    ][    ][    ][    ][    ][    ][    ][    ][    ][    ][    ][    ][    ][#=- ]
[#=- ][    ][    ][    ][    ][    ][    ][    ][    ][    ][    ][    ][    ][    ][#=- ]